+--------------------+          +---------------------+          +-----+        +-----+
|....................|          |.....................|          |.....|        |.....|
|....................|          |.....+---------------+          |.....|        |.....|
|.....+--------+.....|          |.....|                          |.....|        |.....|
|.....|        |.....############.....|                          |.....|        |.....|
|.....|        |.....|          |.....+---------------+          |.....|        |.....|
|.....|        |.....|          |.....................|          |.....|        |.....|
|.....|        |.....|          +---------------+.....|          |.....|        |.....|
|.....|        |.....|                          |.....|          |.....|        |.....|
|.....+--------+.....|                          |.....############.....|        |.....|
|....................|          +---------------+.....|          |.....+--------+.....|
|....................|          |.....................|          |....................|
+---------------#----+          +---------------------+          +---#----------------+                          
                #                                                    #
                ######################################################